200000000000000000000000000000000000000000000000002
200000000000000000000000000000000000000000000000002
200000000000000000000000000000000000222200000000002
200000000000000000000000000000000000000000000000002
200000000000000000000000000000000000000000000000002
200000000000000000000000000000000000000000000000002
200000000000000000000000000222000000000000222220002
000000000000000002222200000000000000000000000000002
200000000000000000000000000000000002202200000000002
200000022222000000000000000000000000000000000000002
200000000000000111111000000000000000000000000000002
200000000000000010001000022200000000000000000000002
200000000000000000000000110000002222200000000000002
200000000000000000000000000000000000000000220000002
200000000000000000000000000000000000000000000000002
200000000000000000000000000002222222222222222222222
200000000000000000000000000001111111111111111111111
222222222222222222222222222222222222222222222222222


*Four blocks(zero's) is the limit for the jumping ability of the hero