000000000000000000000000000000000000000000000000000000000000000000000000000
000000000000000000000002222000000000000000000000000000000000000000000000000
000000000000002222222000110000000222000000000000000000000000000000000000000
000000000000000111110000000000000010000000000000000000000002200000000000000
000000022222000011000000000000000000002222222200000000000000000000000000000
000000000000000000000000000000000000000111111000000000000000000000000000000
000000000000000000000000000000000000000010001000022200000000000000000000000
000000000000000000000000000000000000000000000000011000000000000000000000000
000000000000000000000000000000000000000000000000000000000000000000000000000
000000000000000000000000000000000000000000000000000002222222222222222222222
000000000000000000000000000000000000000000000000000000100000000000000000000
220000000000000002200000022000000000000000000000000000000000000000000000000
112222222222222221100002211220000000000000000000220000000000000000000000000
111111111111111111100001111110000000000000000000000000222200000000000000000
111111111111111111100000110000000000000000000000000000011000000000000000000
111111111111111111100000100000000022222222220000000000000000000000000000000
111111111111111111100000100000000000111111000000000000000000000000000000000
111111111111111111100000000000000000001011000000000000000000000000000000000
000000000000000000000000000000000000000000000000000000000000000000000000000
000000000000000000000000000000000000000000000000000000000000000000000000000
000000000000000000000000000000000000000000000000000000000000000000000000000
000000000000000000000000000000000000000000000000000000000000000000000000000
000000000000000000000000000000000000000000000000000000000000000000000000000
000000000000000000000000000000000000000000000000000000000000000000000000000
000000000000000000000000000000000000000000000000000000000000000000000000000
000000000000000000000000000000000000000000000000000000000000000000000000000
000000000000000000002222222222222222200000000000000000000000000000000000000
000000000000000000000111111111111111000000000000000000000000000000000000000
000000000000000000000000111111110000000000000000000000000000000000000000000
000000000000000000000000001110000000000000000000000000000000000000000000000

*Four blocks(zero's) is the limit for the jumping ability of the hero